zzzzzzzzzz
zzzzzzzzzz
zzzzzzzzzz
zzzzzzzzzz
zzzzDzzzzz
zzzzzzzzzz
zzzzzzzzzz
zzzzzzzzzz
zzzzzzzzzz
Q        Q
QQ      QQ
QQQ    QQQ
QQQ   QQQQ
QQQ  QQQQQ
QQQQ  QQQQ
QQQQQ  QQQ
QQQQQQ  QQ
QQQQQQ  QQ
QQQQ   QQQ
QQ    QQQQ
QQ  QQQQQQ
QQ  QQQQQQ
QQ  QQQQQQ
QQQ  QQQQQ
QQQ    QQQ
QQ      QQ
QQQ Q QQQQ
QQQ Q QQQQ
QQQQ  QQQQ
QQQQ   QQQ
QQQ    QQQ
Q        Q
QQQQQ  QQQ
QQQQQQ  QQ
QQQQQQQ  Q
QQQQQQ  QQ
QQQQQ  QQQ
QQQQ  QQQQ
QQQ  QQQQQ
QQ  QQQQQQ
Q  QQQQQQQ
QQ  QQQQQQ
QQ   QQQQQ
Q     Q QQ
Q        Q
zzzzzzzzzz
zzzzzzzzzz
zzzzzzzzzz
zzzzzzzzzz
zzzzzzzzzz
Q   Q Q  Q
QQ  Q   Qz
  Q      Q
    Qzzzzz
 Q   zzzzz
    Q Q  Q
Q   Q   Qz
  Q      Q
    Qzzzzz
 QQ   Q  Q  
QQ  Q    Q
  Q      Q
    Qzzzzz
 QQ   Q  Q  
QQ  Q   Qz
  Q      Q
    Qzzzzz
 Qzzzzzzzz
zzzzzzzzzz
zzzzzzzzzz
zzzzzzzzzz
zzzzzzzzzz
zzzzzzzzzz
QQQ    QQQ
QQQ   QQQQ
QQQ  QQQQQ
QQQQ  QQQQ
QQQQQ  QQQ
QQQQQQ  QQ
QQQQQQ  QQ
QQQQ   QQQ
QQ    QQQQ
QQ  QQQQQQ
QQ  QQQQQQ
QQ  QQQQQQ
QQQ  QQQQQ
QQQ    QQQ
QQ      QQ
QQQ Q QQQQ
QQQ Q QQQQ
QQQ Q QQQQ
QQQ Q QQQQ
QQQ Q QQQQ
QQQ Q QQQQ
QQQQ  QQQQ
QQQQ   QQQ
QQQ    QQQ
Q        Q
QQQQQ  QQQ
QQQQQQ  QQ
QQQQQQQ  Q
QQQQQQ  QQ
QQQQQ  QQQ
QQQQ  QQQQ
QQQ  QQQQQ
QQ  QQQQQQ
Q  QQQQQQQ
QQ  QQQQQQ
QQ   QQQQQ
Q     Q QQ
Q        Q
zzzzzzzzzz
zzzzzzzzzz
zzzzzzzzzz
zzzzzzzzzz
zzzzzzzzzz
Q   Q Q  Q
QD  Q   Dz
  Q      Q
    Qzzzzz
 D   zzzzz
    Q Q  D
Q   D   Dz
  Q      D
    Qzzzzz
 QD   Q  Q  
QQ  Q    Q
  Q      D
    Qzzzzz
 QQ   Q  D 
QD  D   Qz
  Q      Q
    Dzzzzz
 Dzzzzzzzz
zzzzzzzzzz
zzzzzzzzzz
zzzzzzzzzz
zzzzzzzzzz
zzzzzzzzzz
QQQ    QQQ
QQQ   QQQQ
QQQ  QQQQQ
QQQQ  QQQQ
QQQQQ  QQQ
QQQQQQ  QQ
QQQQQQ  QQ
QQQQ   QQQ
QQ    QQQQ
QQ  QQQQQQ
QQ  QQQQQQ
QQ  QQQQQQ
QQQ  QQQQQ
QQQ    QQQ
QQQ     QQ
QQQ Q QQQQ
QQQ Q QQQQ
QQQ Q QQQQ
QQQ Q QQQQ
QQQ Q QQQQ
QQQ Q QQQQ
QQQ Q QQQQ
QQ   QQQQQ
QQQQ   QQQ
Q      QQQ
Q        Q
QQQQQ  QQQ
QQQQQQ  QQ
QQQQQQQ  Q
QQQQQQ  QQ
QQQQQ  QQQ
QQQQ  QQQQ
QQQ  QQQQQ
QQ  QQQQQQ
Q  QQQQQQQ
QQ  QQQQQQ
QQ   QQQQQ
Q     Q QQ
Q        Q
zzzzzzzzzz
zzzzzzzzzz
zzzzzzzzzz
zzzzzzzzzz
zzzzzzzzzz
WWWWWWWWWW